0,wood,0,,,,,,,,,,,,,,,,,,,,,,,
*,*,*,*,*,*,*,*,*,*,*,*,*,*,*,*,*,*,*,*,*,*,*,*,*,*
*,*,*,*,*,*,*,*,*,*,*,*,*,*,*,*,*,*,*,*,*,*,*,*,*,*
*,*,*,*,*,*,*,*,*,*,*,*,*,*,*,*,*,*,*,*,*,*,*,*,*,*
*,*,*,*,*,*,*,r,r,r,r,r,r,r,r,r,r,r,r,*,*,*,*,*,*,*
*,*,*,*,*,*,*,,,,,,f,.,,,,,,*,*,*,*,*,*,*
*,*,*,*,*,*,*,,,,,,,,%N;4;walter;Walter,,,,,*,*,*,*,*,*,*
*,*,*,*,*,*,*,%A;c,.,.,%A;c,,,,,,,,,*,*,*,*,*,*,*
*,*,*,*,*,*,*,%A;c,e,.,%A;c,,,,,,,,,*,*,*,*,*,*,*
*,*,*,*,*,*,*,,,,,,,,,,,,,*,*,*,*,*,*,*
*,*,*,*,*,*,*,,,,,,,,,,,,,*,*,*,*,*,*,*
*,*,*,*,*,*,*,*,*,*,*,*,%P;;17;5;village0,%P;;17;5;village0,*,*,*,*,*,*,*,*,*,*,*,*
*,*,*,*,*,*,*,*,*,*,*,*,*,*,*,*,*,*,*,*,*,*,*,*,*,*
*,*,*,*,*,*,*,*,*,*,*,*,*,*,*,*,*,*,*,*,*,*,*,*,*,*
*,*,*,*,*,*,*,*,*,*,*,*,*,*,*,*,*,*,*,*,*,*,*,*,*,*
