3,cavefloor,8,,,,,,,,,,,,,,,,,,,,,,,
*,*,*,*,*,*,*,*,*,*,*,*,*,*,*,*,*,*,*,*,*,*,*,*,*,*
*,*,*,*,*,*,*,*,*,*,*,*,a,a,a,a,a,a,a,*,*,*,*,*,*,*
*,*,*,*,*,*,*,*,*,a,a,a,m,,,,,,m,a,a,*,*,*,*,*
*,*,*,*,*,*,*,*,a,m,,,,,,,,,,,m,a,a,*,*,*
*,*,*,*,*,*,*,a,,,,,,,,,,,,,,,m,*,*,*
*,*,*,*,*,*,a,,,,,,m,,,,m,,,,,,,*,*,*
*,*,*,*,a,a,m,,,,,m,,,m,,,,,m,,,,a,*,*
*,*,*,*,,,,,,,,,,*,*,*,,*,*,*,m,,,%P;];22;6;cavemouth2,*,*
*,*,a,a,m,,,,,m,*,*,*,*,*,*,*,*,*,*,*,*,*,*,*,*
*,a,m,,,,,,,*,*,*,*,*,*,*,*,*,*,*,*,*,*,*,*,*
*,,,,,,,,*,*,*,*,*,*,*,*,*,*,*,*,*,*,*,*,*,*
*,,,,,,m,*,*,*,*,*,*,*,*,*,*,*,*,*,*,*,*,*,*,*
*,,,,,,*,*,*,*,*,*,*,*,*,*,*,*,*,*,*,*,*,*,*,*
*,%P;;24;1;cave2,*,*,*,*,*,*,*,*,*,*,*,*,*,*,*,*,*,*,*,*,*,*,*,*
