3,cavefloor,8,,,,,,,,,,,,,,,,,,,,,,,
*,*,*,*,*,*,*,*,*,*,*,*,*,*,*,*,*,*,*,*,*,*,*,*,*,*
*,*,*,*,*,*,*,*,*,*,*,*,,,,,,*,*,*,*,*,*,*,*,*
*,*,*,*,*,*,*,*,*,,,,,,,,,,,*,,*,*,*,*,*
*,*,*,*,*,*,*,*,,,,,,,,,,,,,,,,*,*,*
*,*,*,*,*,*,*,,,,*,*,*,*,*,*,*,*,*,,,,,*,*,*
*,*,*,*,*,*,,,,,*,*,*,*,*,*,*,*,*,*,,,,,*,*
*,*,*,*,*,,,*,*,*,*,*,*,*,*,*,*,*,*,*,*,*,,*,*,*
*,*,*,*,,,*,*,*,*,*,*,*,*,*,*,*,*,*,*,*,*,,*,*,*
*,*,,,,*,*,*,*,*,*,*,*,*,*,*,*,*,*,*,*,*,%P;;22;6;cavemouth2,*,*,*
*,*,,,*,*,*,*,*,*,*,*,*,*,*,*,*,*,*,*,*,*,*,*,*,*
*,*,,,*,*,*,*,*,*,*,*,*,*,*,*,*,*,*,*,*,*,*,*,*,*
*,,,,*,*,*,*,*,*,*,*,*,*,*,*,*,*,*,*,*,*,*,*,*,*
*,,,*,*,*,*,*,*,*,*,*,*,*,*,*,*,*,*,*,*,*,*,*,*,*
*,%P;;24;1;cave2,*,*,*,*,*,*,*,*,*,*,*,*,*,*,*,*,*,*,*,*,*,*,*,*