3,cavefloor,8,,,,,,,,,,,,,,,,,,,,,,,
*,*,*,*,*,*,*,*,*,*,*,*,*,*,*,*,*,*,*,*,*,*,*,*,%P;;1;12;cave2,*
*,*,*,*,*,*,*,*,*,*,*,*,*,*,*,*,*,*,*,*,*,*,*,,,*
*,*,*,*,*,*,*,*,*,*,*,*,*,*,*,*,*,*,*,*,*,*,,,*,*
*,*,*,*,*,*,*,*,*,*,*,*,*,*,*,*,*,*,*,*,*,,,*,*,*
*,*,*,*,*,*,*,*,*,*,*,*,*,*,*,*,*,*,*,,,,*,*,*,*
*,*,*,*,*,*,*,*,*,*,*,*,*,*,*,*,*,,,,,,*,*,*,*
*,*,*,*,*,*,*,*,*,*,*,*,*,*,*,,,,,,*,*,*,*,*,*
*,*,*,*,*,*,*,*,*,*,,,,,,,,,*,*,*,*,*,*,*,*
*,*,*,*,*,*,*,*,*,,,,,,,,*,*,*,*,*,*,*,*,*,*
*,*,*,*,*,*,,,,,,,*,*,*,*,*,*,*,*,*,*,*,*,*,*
*,*,*,*,,,,,,*,*,*,*,*,*,*,*,*,*,*,*,*,*,*,*,*
*,*,*,,,,,*,*,*,*,*,*,*,*,*,*,*,*,*,*,*,*,*,*,*
*,,,,,,*,*,*,*,*,*,*,*,*,*,*,*,*,*,*,*,*,*,*,*
*,%P;;3;8;cavemouth1,*,*,*,*,*,*,*,*,*,*,*,*,*,*,*,*,*,*,*,*,*,*,*,*