3,cavefloor,8,,,,,,,,,,,,,,,,,,,,,,,
*,*,*,*,*,*,*,*,*,*,*,*,*,*,*,*,*,*,*,*,*,*,*,*,%P;;1;12;cave3,*
*,*,*,*,*,*,*,*,*,*,*,*,*,*,*,*,*,*,*,*,*,*,*,,,*
*,*,*,*,*,*,,,*,*,*,*,*,*,*,*,*,*,*,*,*,*,,,*,*
*,*,*,*,,,,,*,*,*,*,*,*,*,*,*,*,*,*,*,,,*,*,*
*,*,*,,,%N;W;wisemanlledo;Wise Man Lledo,,,,,*,*,*,*,*,*,*,*,*,,,,*,*,*,*
*,*,*,,,,,,,,,*,*,*,*,*,*,,,,,,*,*,*,*
*,*,*,*,,,,,,*,,*,*,*,*,,,,,,*,*,*,*,*,*
*,*,*,*,,,,*,*,*,,,,,,,,,*,*,*,*,*,*,*,*
*,*,*,*,*,*,*,*,*,,,,,,,,*,*,*,*,*,*,*,*,*,*
*,*,*,*,*,*,,,,,,,*,*,*,*,*,*,*,*,*,*,*,*,*,*
*,*,*,*,,,,,,*,*,*,*,*,*,*,*,*,*,*,*,*,*,*,*,*
*,*,*,,,,,*,*,*,*,*,*,*,*,*,*,*,*,*,*,*,*,*,*,*
*,,,,,,*,*,*,*,*,*,*,*,*,*,*,*,*,*,*,*,*,*,*,*
*,%P;;24;1;cave1,*,*,*,*,*,*,*,*,*,*,*,*,*,*,*,*,*,*,*,*,*,*,*,*