0,wood,0,,,,,,,,,,,,,,,,,,,,,,,
*,*,*,*,*,*,*,*,*,*,*,*,*,*,*,*,*,*,*,*,*,*,*,*,*,*
*,*,*,*,*,*,*,*,*,*,*,*,*,*,*,*,*,*,*,*,*,*,*,*,*,*
*,*,*,*,*,*,*,*,*,*,*,*,*,*,*,*,*,*,*,*,*,*,*,*,*,*
*,*,*,*,*,*,*,r,r,r,r,r,r,r,r,r,r,r,r,*,*,*,*,*,*,*
*,*,*,*,*,*,*,,,,,,f,.,,,,,,*,*,*,*,*,*,*
*,*,*,*,*,*,*,,,,,,,,,,,,,*,*,*,*,*,*,*
*,*,*,*,*,*,*,%A;c,.,.,%A;c,,,,,%N;o;colonel;Colonel Sanders,,,,*,*,*,*,*,*,*
*,*,*,*,*,*,*,%A;c,e,.,%A;c,,,,,,,,,*,*,*,*,*,*,*
*,*,*,*,*,*,*,,,,,,,,,,,,,*,*,*,*,*,*,*
*,*,*,*,*,*,*,,,,,,,,,,,,,*,*,*,*,*,*,*
*,*,*,*,*,*,*,*,*,*,*,*,%P;;21;2;citysouth,%P;;21;2;citysouth,*,*,*,*,*,*,*,*,*,*,*,*
*,*,*,*,*,*,*,*,*,*,*,*,*,*,*,*,*,*,*,*,*,*,*,*,*,*
*,*,*,*,*,*,*,*,*,*,*,*,*,*,*,*,*,*,*,*,*,*,*,*,*,*
*,*,*,*,*,*,*,*,*,*,*,*,*,*,*,*,*,*,*,*,*,*,*,*,*,*