0,dirtstone,,,,,,,,,,,,,,,,,,,,,,,,
*,*,*,*,*,*,*,*,*,*,*,*,*,*,*,*,*,*,*,*,*,*,*,*,*,*
*,*,*,*,*,*,*,*,*,*,*,*,*,*,*,*,*,*,*,*,*,*,*,*,*,*
*,*,*,*,*,*,*,*,*,*,*,*,*,*,*,*,*,*,*,*,*,*,*,*,*,*
*,*,*,*,*,*,*,,,,,,,,,,,,,*,*,*,*,*,*,*
*,*,*,*,*,*,,,,,,,,,,,,,,,*,*,*,*,*,*
*,*,*,*,*,,,,,,,,,,,,,,,,,*,*,*,*,*
*,*,*,*,*,,,,,,,,%N;W;theslapper;Wise Man Lledo,,,,,,,,,*,*,*,*,*
*,*,*,*,*,,,,,,,,,,,,,,,,,*,*,*,*,*
*,*,*,*,*,,,,,,,,,,,,,,,,,*,*,*,*,*
*,*,*,*,*,*,,,,,,,,,,,,,,,*,*,*,*,*,*
*,*,*,*,*,*,*,,,,,,,,,,,,,*,*,*,*,*,*,*
*,*,*,*,*,*,*,*,*,*,*,*,%P;;20;11;test,*,*,*,*,*,*,*,*,*,*,*,*,*
*,*,*,*,*,*,*,*,*,*,*,*,*,*,*,*,*,*,*,*,*,*,*,*,*,*
*,*,*,*,*,*,*,*,*,*,*,*,*,*,*,*,*,*,*,*,*,*,*,*,*,*
