0,dirtstone,0,,,,,,,,,,,,,,,,,,,,,,,
*,*,*,*,*,*,*,*,*,*,*,*,*,*,*,*,*,*,*,*,*,*,*,*,*,*
*,*,*,*,*,*,*,*,*,*,*,*,*,*,*,*,*,*,*,*,*,*,*,*,*,*
*,*,*,*,*,*,*,*,*,*,*,*,*,*,*,*,*,*,*,*,*,*,*,*,*,*
*,*,*,*,*,*,*,*,*,*,*,*,*,*,*,*,*,*,*,*,*,*,*,*,*,*
*,*,*,*,*,*,*,*,,,,,,,,,,,*,*,*,*,*,*,*,*
*,*,*,*,*,*,*,,%V,,,,,,,,%V,,,*,*,*,*,*,*,*
*,*,*,*,*,*,*,,,,,,,,,,,,,*,*,*,*,*,*,*
*,*,*,*,*,*,*,,,,,,,%v,,,,,,*,*,*,*,*,*,*
*,*,*,*,*,*,*,,,,,,,,,,,,,*,*,*,*,*,*,*
*,*,*,*,*,*,*,*,,,,,,,,,,,*,*,*,*,*,*,*,*
*,*,*,*,*,*,*,*,*,*,*,*,%P;;9;11;village1,%P;;9;11;village2,*,*,*,*,*,*,*,*,*,*,*,*
*,*,*,*,*,*,*,*,*,*,*,*,*,*,*,*,*,*,*,*,*,*,*,*,*,*
*,*,*,*,*,*,*,*,*,*,*,*,*,*,*,*,*,*,*,*,*,*,*,*,*,*
*,*,*,*,*,*,*,*,*,*,*,*,*,*,*,*,*,*,*,*,*,*,*,*,*,*