0,dirtstone,0,,,,,,,,,,,,,,,,,,,,,,,
*,*,*,*,*,*,*,*,*,*,*,*,*,*,*,*,*,*,*,*,*,*,*,*,*,*
*,*,*,*,*,*,*,*,*,*,*,*,*,*,*,*,*,*,*,*,*,*,*,*,*,*
*,*,*,*,*,*,*,*,*,*,*,*,*,*,*,*,*,*,*,*,*,*,*,*,*,*
*,*,*,*,*,*,*,*,*,*,*,*,*,*,*,*,*,*,*,*,*,*,*,*,*,*
*,*,*,*,*,*,*,*,%V,,,,,,,,,,*,*,*,*,*,*,*,*
*,*,*,*,*,*,*,,,,,,,,,%V,,,,*,*,*,*,*,*,*
*,*,*,*,*,*,*,,,,,,%V,,,,,,,*,*,*,*,*,*,*
*,*,*,*,*,*,*,,,,,,,,,,,,,*,*,*,*,*,*,*
*,*,*,*,*,*,*,,,,,,,,,,,,,*,*,*,*,*,*,*
*,*,*,*,*,*,*,*,,,,,,,,,,,*,*,*,*,*,*,*,*
*,*,*,*,*,*,*,*,*,*,*,*,%P;;21;9;village2,%P;;21;9;village2,*,*,*,*,*,*,*,*,*,*,*,*
*,*,*,*,*,*,*,*,*,*,*,*,*,*,*,*,*,*,*,*,*,*,*,*,*,*
*,*,*,*,*,*,*,*,*,*,*,*,*,*,*,*,*,*,*,*,*,*,*,*,*,*
*,*,*,*,*,*,*,*,*,*,*,*,*,*,*,*,*,*,*,*,*,*,*,*,*,*