0,wood,0,,,,,,,,,,,,,,,,,,,,,,,
*,*,*,*,*,*,*,*,*,*,*,*,*,*,*,*,*,*,*,*,*,*,*,*,*,*
*,*,*,*,*,*,*,*,*,*,*,*,*,*,*,*,*,*,*,*,*,*,*,*,*,*
*,*,*,*,*,*,*,*,*,*,*,*,*,*,*,*,*,*,*,*,*,*,*,*,*,*
*,*,*,*,*,*,*,r,r,r,r,r,r,r,r,r,r,r,r,*,*,*,*,*,*,*
*,*,*,*,*,*,*,,,,,,f,.,,,,,,*,*,*,*,*,*,*
*,*,*,*,*,*,*,,,,%V,,,,,,,,,*,*,*,*,*,*,*
*,*,*,*,*,*,*,%A;c,.,.,%A;c,,,,,,,,,*,*,*,*,*,*,*
*,*,*,*,*,*,*,%A;c,e,.,%A;c,,,,,,,%V,,*,*,*,*,*,*,*
*,*,*,*,*,*,*,,,,,,,,,,,,,*,*,*,*,*,*,*
*,*,*,*,*,*,*,,,,,,,,,,,,,*,*,*,*,*,*,*
*,*,*,*,*,*,*,*,*,*,*,*,%P;;8;7;village1,%P;;8;7;village2,*,*,*,*,*,*,*,*,*,*,*,*
*,*,*,*,*,*,*,*,*,*,*,*,*,*,*,*,*,*,*,*,*,*,*,*,*,*
*,*,*,*,*,*,*,*,*,*,*,*,*,*,*,*,*,*,*,*,*,*,*,*,*,*
*,*,*,*,*,*,*,*,*,*,*,*,*,*,*,*,*,*,*,*,*,*,*,*,*,*
