0,dirtstone,0,,,,,,,,,,,,,,,,,,,,,,,
*,*,*,*,*,*,*,*,*,*,*,*,*,*,*,*,*,*,*,*,*,*,*,*,*,*
*,*,*,*,*,*,*,*,*,*,*,*,*,*,*,*,*,*,*,*,*,*,*,*,*,*
*,*,*,*,*,*,*,*,*,*,*,*,*,*,*,*,*,*,*,*,*,*,*,*,*,*
*,*,*,*,*,*,*,*,*,*,*,*,*,*,*,*,*,*,*,*,*,*,*,*,*,*
*,*,*,*,*,*,*,*,,,,,,,,%V,,,*,*,*,*,*,*,*,*
*,*,*,*,*,*,*,,,%V,,,,,,,,,,*,*,*,*,*,*,*
*,*,*,*,*,*,*,,,,,,,,,,,,,*,*,*,*,*,*,*
*,*,*,*,*,*,*,,,,,%V,,,,,,,,*,*,*,*,*,*,*
*,*,*,*,*,*,*,,,,,,,,,,,,,*,*,*,*,*,*,*
*,*,*,*,*,*,*,*,,,,,,,,,,,*,*,*,*,*,*,*,*
*,*,*,*,*,*,*,*,*,*,*,*,%P;;15;6;village1,%P;;15;6;village2,*,*,*,*,*,*,*,*,*,*,*,*
*,*,*,*,*,*,*,*,*,*,*,*,*,*,*,*,*,*,*,*,*,*,*,*,*,*
*,*,*,*,*,*,*,*,*,*,*,*,*,*,*,*,*,*,*,*,*,*,*,*,*,*
*,*,*,*,*,*,*,*,*,*,*,*,*,*,*,*,*,*,*,*,*,*,*,*,*,*