0,dirtstone,0,,,,,,,,,,,,,,,,,,,,,,,
*,*,*,*,*,*,*,*,*,*,*,*,*,*,*,*,*,*,*,*,*,*,*,*,*,*
*,*,*,*,*,*,*,*,*,*,*,*,*,*,*,*,*,*,*,*,*,*,*,*,*,*
*,*,*,*,*,*,*,*,*,*,*,*,*,*,*,*,*,*,*,*,*,*,*,*,*,*
*,*,*,*,*,*,*,*,*,*,*,*,*,*,*,*,*,*,*,*,*,*,*,*,*,*
*,*,*,*,*,*,*,*,%V,,,,,,,,,,*,*,*,*,*,*,*,*
*,*,*,*,*,*,*,,,,,,,,,,,,,*,*,*,*,*,*,*
*,*,*,*,*,*,*,,,,,,,,,,,,,*,*,*,*,*,*,*
*,*,*,*,*,*,*,,,,,,,,%V,,,,,*,*,*,*,*,*,*
*,*,*,*,*,*,*,,,,,,,,,,,,,*,*,*,*,*,*,*
*,*,*,*,*,*,*,*,,,,,,,,,,,*,*,*,*,*,*,*,*
*,*,*,*,*,*,*,*,*,*,*,*,%P;;11;9;village2,%P;;11;9;village3,*,*,*,*,*,*,*,*,*,*,*,*
*,*,*,*,*,*,*,*,*,*,*,*,*,*,*,*,*,*,*,*,*,*,*,*,*,*
*,*,*,*,*,*,*,*,*,*,*,*,*,*,*,*,*,*,*,*,*,*,*,*,*,*
*,*,*,*,*,*,*,*,*,*,*,*,*,*,*,*,*,*,*,*,*,*,*,*,*,*