2,wood,0,,,,,,,,,,,,,,,,,,,,,,,
*,*,*,*,*,*,*,*,*,*,*,*,*,*,*,*,*,*,*,*,*,*,*,*,*,*
*,*,*,*,*,*,*,*,*,*,*,*,*,*,*,*,*,*,*,*,*,*,*,*,*,*
*,*,*,*,*,*,*,*,*,*,*,*,*,*,*,*,*,*,*,*,*,*,*,*,*,*
*,*,*,*,*,,,,,,,,%W;2,,,,,,,,,*,*,*,*,*
*,*,*,*,*,,,,,,,,,,,,,,,,,*,*,*,*,*
*,*,*,*,*,,,,,,,,,,,,,,,,,*,*,*,*,*
*,*,*,*,*,,,,,,,,,,,,,,,,,*,*,*,*,*
*,*,*,*,*,,,,,,,,,,,,,,,,,*,*,*,*,*
*,*,*,*,*,,,,,,,,,,,,,,,,,*,*,*,*,*
*,*,*,*,*,*,*,*,*,*,*,*,%P;;19;5;village2,%P;;20;5;village2,*,*,*,*,*,*,*,*,*,*,*,*
*,*,*,*,*,*,*,*,*,*,*,*,*,*,*,*,*,*,*,*,*,*,*,*,*,*
*,*,*,*,*,*,*,*,*,*,*,*,*,*,*,*,*,*,*,*,*,*,*,*,*,*
*,*,*,*,*,*,*,*,*,*,*,*,*,*,*,*,*,*,*,*,*,*,*,*,*,*
*,*,*,*,*,*,*,*,*,*,*,*,*,*,*,*,*,*,*,*,*,*,*,*,*,*