0,wood,0,,,,,,,,,,,,,,,,,,,,,,,
*,*,*,*,*,*,*,*,*,*,*,*,*,*,*,*,*,*,*,*,*,*,*,*,*,*
*,*,*,*,*,*,*,*,*,*,*,*,*,*,*,*,*,*,*,*,*,*,*,*,*,*
*,*,*,*,*,*,*,*,*,*,*,*,*,*,*,*,*,*,*,*,*,*,*,*,*,*
*,*,*,*,*,*,*,r,r,r,r,r,r,r,r,r,r,r,r,*,*,*,*,*,*,*
*,*,*,*,*,*,*,,,,,,f,.,,,,,,*,*,*,*,*,*,*
*,*,*,*,*,*,*,,,,,,,,%V,,,,,*,*,*,*,*,*,*
*,*,*,*,*,*,*,%A;c,.,.,%A;c,,,,,,,,,*,*,*,*,*,*,*
*,*,*,*,*,*,*,%A;c,e,.,%A;c,,,,,,,,,*,*,*,*,*,*,*
*,*,*,*,*,*,*,,,,,,,,,,,%V,,*,*,*,*,*,*,*
*,*,*,*,*,*,*,,,,,,,,,,,,,*,*,*,*,*,*,*
*,*,*,*,*,*,*,*,*,*,*,*,%P;;4;10;village1,%P;;4;10;village2,*,*,*,*,*,*,*,*,*,*,*,*
*,*,*,*,*,*,*,*,*,*,*,*,*,*,*,*,*,*,*,*,*,*,*,*,*,*
*,*,*,*,*,*,*,*,*,*,*,*,*,*,*,*,*,*,*,*,*,*,*,*,*,*
*,*,*,*,*,*,*,*,*,*,*,*,*,*,*,*,*,*,*,*,*,*,*,*,*,*
