0,dirtstone,0,,,,,,,,,,,,,,,,,,,,,,,
*,*,*,*,*,*,*,*,*,*,*,*,*,*,*,*,*,*,*,*,*,*,*,*,*,*
*,*,*,*,*,*,*,*,*,*,*,*,*,*,*,*,*,*,*,*,*,*,*,*,*,*
*,*,*,*,*,*,*,*,*,*,*,*,*,*,*,*,*,*,*,*,*,*,*,*,*,*
*,*,*,*,*,,,,,,,,%W;3,,,,,,,,,*,*,*,*,*
*,*,*,*,*,,,,,,,,,,,,,,,,,*,*,*,*,*
*,*,*,*,*,,,,,,,,,,,,,,,,,*,*,*,*,*
*,*,*,*,*,,,,,,,,,,,,,,,,,*,*,*,*,*
*,*,*,*,*,,,,,,,,,,,,,,,,,*,*,*,*,*
*,*,*,*,*,,,,,,,,,,,,,,,,,*,*,*,*,*
*,*,*,*,*,*,*,*,*,*,*,*,%P;;20;5;village3,%P;;21;5;village3,*,*,*,*,*,*,*,*,*,*,*,*
*,*,*,*,*,*,*,*,*,*,*,*,*,*,*,*,*,*,*,*,*,*,*,*,*,*
*,*,*,*,*,*,*,*,*,*,*,*,*,*,*,*,*,*,*,*,*,*,*,*,*,*
*,*,*,*,*,*,*,*,*,*,*,*,*,*,*,*,*,*,*,*,*,*,*,*,*,*
*,*,*,*,*,*,*,*,*,*,*,*,*,*,*,*,*,*,*,*,*,*,*,*,*,*